"Numer rachunku/karty","Data transakcji","Data rozliczenia","Rodzaj transakcji","Na konto/Z konta","Odbiorca/Zleceniodawca","Opis","Obciążenia","Uznania","Saldo","Waluta"
"PL00 1160 2202 0000 1234 5678 8000","2014-09-20","2014-09-20","PRZELEW WEWNĘTRZNY WYCHODZĄCY","","AAA BBB","Przelew własny","-1234.00","","933.89","PLN"
"PL00 1160 2202 0000 1234 5678 8000","2014-09-19","2014-09-19","OBCIĄŻENIE","","","PODATEK OD ODSETEK","-11.22","","2167.89","PLN"
"PL00 1160 2202 0000 1234 5678 8000","2014-09-18","2014-09-18","UZNANIE","","","KAPITALIZACJA ODS.","","55.66","2179.11","PLN"
"PL00 1160 2202 0000 1234 5678 8000","2014-09-17","2014-09-17","PRZELEW PRZYCHODZĄCY","11 22 2233 3344 4455 5566 6677 77","AAA BBB, Warszawa","Bardzo dlugi tytul na ponad 60 znakow ktore trzeba bedzie przyciac","","123.45","2123.45","PLN"
"PL99 1160 2202 0000 1234 5678 9000","2014-09-14","2014-09-16","TRANSAKCJA KARTĄ PŁATNICZĄ","","","Trans","-3.00","","1990.37","PLN"
"PL99 1160 2202 0000 1234 5678 9000","2014-09-13","2014-09-13","WYPŁATA KARTĄ Z BANKOMATU","","","xx1","-3.52","","1993.37","PLN"
"PL99 1160 2202 0000 1234 5678 9000","2014-09-12","2014-09-12","WYPŁATA KARTĄ Z BANKOMATU","","","xx1","-3.11","","1996.89","PLN"